8 21
|-------------------|
|.*....|....|...F...|
|----...F...|......*|
|...........@...|---|
|...F..|........|...|
|----..|...*....|...|
|...*..|---......F..|
|-------------------|